############
 # # ###  #B
 # #   # ## 
   # #   ## 
# ## # # ## 
#    # #    
### ## #####
A   ##      