#########
#A      #
# # ### #
# #   # #
# ### # #
#     # #
### ### #
#     B #
#########