###                  #########
#   ####################   # #
# ####                 # # # #
# #################### # # # #
#                      # # # #
###################### # # # #
#   ##                 # # # #
# # ## ### ## ########## # # #
# #    #   ##B#          # # #
# # ## ################# # # #
### ##              #### # # #
### ############### ## # # # #
###              ##    # # # #
###### ######### ####### # # #
###### ####              #   #
A      #######################